.entrance
1111111111
0001110000
0001110000
0000000000
0000D00000
0011110000
0011111000
1111111111

.entrance_down
1111111111
0000000000
0000000000
000D000000
0011100000
0011000100
0111000110
1111001111

.exit
1111111111
0000000000
0000000000
0000000000
0000000000
0000000000
0000D00000
1111111111

.exit_up
1111001111
0000001110
0000011100
0000001100
0000001000
0001000000
0D01000000
1111111111

.side
1111111111
1000000001
1000000001
0000000000
0000110000
1000000001
1000000001
1111111111

.path
1111111111
0000000000
0000000000
0000000000
0001100000
0001100000
0011100111
1111111111

.path_up
1111001111
1100000000
0100011000
0000001000
0000011000
0000000000
0011000111
1111111111

.path_down
1111111111
0011110000
0011100000
0000110000
0000000000
0000000010
0000000110
1111001111

.path_vert
0000001111
0011000000
0110000000
0000000000
0000001100
0000001100
0000001110
1111001111
